135
128
.......................................................................................................................................
.......................................................................................................................................
.......................................................................................................................................
............aaaaaaaaaaaaaaa........................................######..............................................................
..................................................................#########............................................................
.................................................................#########..##.........................................................
..........bbbbbbbbbbbbbbbb...................................$$$$######....######....................#.................................
.............................................................$#######3...8########.....................................................
.............................................................$######2...6#########...................5.................................
.............ccccccccccccccc..................................######2..23##########..................36................................
..................................................................49..3############...................##...............................
.....................................................................44############...................###..............................
..............................................................####################......................#..............................
.............................................................#####################......###.............#..............................
.............................................................####################.......###$...........................................
..........................................................######################........###$.........#3................................
.........................................................#######################......2..##$........#3.................................
.........................................................######################.......2..##$...........4...............................
........................................................#######################......#9..#$...........#5...............................
........................................................######################.......$5...............##2..............................
.......................................................######################........$#3...........##.##3..............................
......................................................#######################......................##..##..............................
......................................................#######################......................##..................................
.....................................................4#######################......................5###................................
.....................................................4######################.....................24....................................
......................................................3##99################......................13....................................
......................................................289.9###############.............................................................
.......................................................1..9##############..............................................................
.......................................................$..999############..............................................................
.......................................................$9....9##########...............................................................
.......................................................$...99###########..............................$................................
.......................................................$..45############.............................$$................................
.......................................................$..8#############...............................................................
.........................................................################..............................................................
.........................................................################..............................................................
........................................................#################..............................................................
.......................................................##################..............................................................
.......................................................##################..............................................................
......................................................###################..............................................................
.....................................................####################..............................................................
....................................................####################...............................................................
...................................................#####################3..............................................................
............ddddddddddddddd......................#######################3..............................................................
.................................................#######################3..............................................................
...............................................#########################...............................................................
.............eeeeeeeeeeeeeee................############################...............................................................
...........................................########################....................................................................
..........................................#######################$.....................................................................
............fffffffffffffff.............########################$......................................................................
.......................................#########################$......................................................................
......................................##########################$......................................................................
.....................................###########################$......................................................................
.....................................###########################$......................................................................
....................................############################$......................................................................
....................................#############################......................................................................
...................................$##############################......$$$............................................................
...................................$##99###########################.....$$$............................................................
..................................$$##7.7##########################.....$$$............................................................
..................................$##8..8#########################...#..$$$............................................................
...................................$#3..5########################....#...$$............................................................
...................................$$5..5########################....##................................................................
.....................................$..$##########################...#................................................................
........................................$#########################.....#...............................................................
......................................$$$#########################..#..#...............................................................
....................................$$############################..984#...............................................................
....................................$#############################.#####...............................................................
....................................$############################9.9####...............................................................
....................................$#############################999####..............................................................
....................................$####################################..............................................................
....................................$$####################################.............................................................
.....................................$###################################3.............................................................
.....................................#####################################44...........................................................
.......................#.............#######################################...........................................................
......................###.............######################################...........................................................
......................$##..............#####################################...........................................................
.....................#$#3...............###4################################...........................................................
.....................###5................#.44################################..........................................................
.....................###6....................3###############################..........................................................
.....................####.....................##############################...........................................................
.................##..2###.....................##############..#####345######...........................................................
................###..3##6......................###########8...#####..######............................................................
...............#####.8###5......................##########7..7####..#...###............................................................
..............######9####2......................##########5.4###.......................................................................
..............###########4......................###########..........#$................................................................
..............$############......................########........##..$.................................................................
..............$############$.....................######.....####..9#$$.................................................................
...............############$$.....................####....######9..$...................................................................
................############$.....................####..#.########.....................................................................
................#############......................#...#..######.................................................$#356#................
................##############........................#9..9####..................................................#######...............
.................#############........................#9#9####..................................................#########..............
.................#############.......................#########.......................................##........$#########..............
.................##############.....................##########......................................8##.........#########..............
.................$##############...................#########44.......................................5##........46#######..............
.................$#############2...................########4........................................3###7.....5..8######33.............
..................$############4...................########4........................................####4.....4..62######4.............
..................$#####239####5..................$########44.......................................####33...##...3####$35.............
.....................###6..8###3..................$##########.......................................#####8...###..8####5...............
...........................9#####.................$##########.......................................$####33..##6..6####3...............
.........................3272####..................$#########.......................................$#2###9.95#4..3####2...............
........................#########..................$#########.........................................3###5..33..4######...............
........................##########..................$########..........................................6##.......#######...............
........................###########.................$########.......................................##..........########...............
........................############.................$$$###.........................................7##.........########...............
........................#############..................$##....................................###..3####.......########................
.........................#############.................$$$...................................$###...5##........#####47#................
..........................##############.................$6................................$$####...8##3.......###23...................
...........................##############.............................................############..8##6........##3....................
............................#############...........................................8############3..6#9.........#5.....................
.............................############..........................................42############3..435................................
..........................#...###########...........................................3############5...3.....$$##........................
..........................4##..#########3...........................................46###########6........7$###3.......................
.........................535##...######6.............................................#############8.9..443#####5.......................
............................###......##8...............................................############...42#######........................
............................######...#5.................................................###########...3########........................
............................$#######....................................................43##########..2#######.........................
............................$#######.....................................................5##########...######..........................
.............................$######........................................................#######3...$$###...........................
.............................$######.........................................................####345....$$.............................
..............................######...............................................................8...................................
..............................######...................................................................................................
...............................######..................................................................................................
................................####5..................................................................................................
...................................44..................................................................................................
....................................3..................................................................................................
.......................................................................................................................................
.......................................................................................................................................
.......................................................................................................................................
