100
100
#####################.........................................................$#####################
######################........................................................$#####################
#######################789................................................44445#####################
##########################23............................................#3##########################
###########################1.........................................###############################
############################8......................................7################################
###########################7......................................8#5###############################
###########################4.....$...............................9##################################
########.33333###############....##.............................3########$###...54163$$#############
#######5....4###############.....###3...........................$#######$..........9...$############
#######5.....5##############3....####26.........................$#$##$..................5###########
#######7......2##############2..7######7aa.................$.................4#.........6###########
#######6.......1##############1..8######aaa..............$$#436.............3##$.....9..############
########$........############5...8#######aaa.............####..............22##$....7#336###########
########$.........###########8...3########$a.............$##...............#####...6################
#######$..........#########......2#########$a...........#.....33###......$##########################
#######8...............###.......$#########$..................2####5.....$##########################
#######7..........................$#######$...................1####3....$###########################
#######3....##bbbb.................$#####$.....................$$##2.....###########################
#######1.....##bbb.........9#....................................$##......#$$$#....#666666$#########
########....2####b.........$......................................$#8.....................$$$#######
########....4####b...............................................44##3......................$#######
########....5###b.................................................4#####.......................#####
#######.....$$$........................$$$$$......................#######.......$..............#####
#######..............................######7.......................$$####.......9........$$....#####
#######$........................$###########5.........................###......#$........$#....#####
#######$........................$###########6.......................................$$...56#...#####
#######$........4...............$###########3.......................................$#....4#...#####
########$.......$$...............543##$######c............................$9........#3..........####
########$.........................7....$#####cc.....................................#6..........####
#########$..............................$8##ccc.....................................$#7.........$###
#########$................................6##cc.....................................$$#8.........$##
###########................................6#cc......................................$#....8##...$##
##########6...##...........................................................................##....###
#######..78...###..........................................................................##$....##
#######......###$....#....................................................................####....7#
#######......###$....$#..................................................................####7.....3
#######5.....###$....#...................................................................$###9.....2
#######3.....4##$.......................................................................$####8.....3
#######4.....4####.....................................................................$####5......$
#######4......$###.....................................................................####$......##
########...4231###...................................................................####.........##
###########7..$$$$..................................................................8###.........###
############6.........#..........................................................5..5##.....8...####
#############4........#..........................................................$..............####
##############5......###.........................................................##.............####
#############........$####.......................................................$##...........#####
############.......$$####.....................................................................######
############......$#######...............................................................55#########
###########.......4442####..............................................................3###########
###########..........987##..............................................................$###########
##########..............##.............................................................$############
##########..............##.............................................................#############
##########.............................................................................#############
########$..............................................................................###$$$$$5####
#######$...............................................................................##......29###
########$........$#5....$#.......................................................................81#
########$.......$#4.....$##........................................................$......4.......7#
########.......$##7...4$$##.......................................................$########5......7#
########ee....$###3...4####......................................................$##########4.....$#
#######ee.....$##2....4#####....................................................############4...55##
######eee.....$##8....#####.....................................................3###########3...3###
######eee....$###......#........................................................3############$$1####
#####$......#####................................................................3##################
#####8.....######................................................................###################
#####9.....4####d...........................................................#....###################
#####9.....5##dd............................................................#.....##################
#####4....2###dd...........................................................5.....###################
#####2..$$###dd...........................................................$......###################
#####4..$###ddd..................................................................$##################
#####4$$$#.......................................................................$##################
##########.......................................................................4##################
##########...................................................................##...3#################
#######$$$...$..............................................................$##...2#################
######$.....................................................................###.....################
######$......................................................................##$.....###############
#######......................................................................##6......##############
######$.......................................................................#.......##############
######$....#......................................................................#...$#############
######$$...2#....................................................................3#..$##############
########....3#....................................................................$...$#############
########....3##.............................................................3.........##############
########....$$#..........................................................##7$.........##############
########..........#..........##......................................########........###############
########....................####.....................................#######........################
########..................###########................................######$........################
########.................##########$................................#######$.....###################
#########...............$#########$$...............................$######7.....####################
##########..............$#####56#$................................$$####489.....$###################
##########....$..........84###9....................................$##.........$####################
##########.....####3......7###......................................#.........$#####################
##########4.....####1.....6##..................................................$####################
##########3.....$####......#.............................................##...######################
###########53...$$32###.................................................65#...######################
###########5........55#.................................................8$$.....####################
############.......................................................................#################
############.........................................................................###############
#############.........................................................................$#############
############$$...$.....................................................................$############
##############776.......................................................................$###########
