80
80
................................................................................
................................................................................
..lll...mmm...nnn...ooo...ppp...qqq...rrr...sss...ttt...uuu...vvv...www...xxx...
..lll...mmm...nnn...ooo...ppp...qqq...rrr...sss...ttt...uuu...vvv...www...xxx...
..lll...mmm...nnn...ooo...ppp...qqq...rrr...sss...ttt...uuu...vvv...www...xxx...
................................................................................
................................................................................
................................................................................
................................................................................
................................................................................
................................................................................
................................................................................
................................................................................
................................................................................
................................................................................
................................................................................
................................................................................
................................................................................
................................................................................
................................................................................
................................................................................
................................................................................
................................................................................
................................................................................
................................................................................
................................................................................
................................................................................
...........................................7....................................
..........................................7#$...................................
.......................................666###$..................................
..................................##354#########$...............................
..............................#####################.............................
.......................$$###########################............................
....................9#################################..........................
...............#########################################9.......................
............#############################################99.....................
.........##################################################999..................
.......########################################################8................
....98############################################################..............
..448###############################################################$...........
...$$$$$$############################################################$$.........
..........#############################################################$........
............##############################################################......
...............##########################################################8......
......................99999###############################################9.....
...........................88.....#########################################9....
.....................................#######################################....
.......................................999###################################...
..........................................###################################...
.............................................$$$$$$$$$$$######################..
...................................................................9999########.
..........................................................................#####.
..............................................................................#.
................................................................................
................................................................................
................................................................................
................................................................................
................................................................................
................................................................................
................................................................................
................................................................................
................................................................................
................................................................................
................................................................................
................................................................................
................................................................................
................................................................................
................................................................................
................................................................................
................................................................................
................................................................................
................................................................................
................................................................................
................................................................................
................................................................................
..aaa...bbb...ccc...ddd...eee...fff...ggg...hhh...iii...jjj...kkk...yyy...zzz...
..aaa...bbb...ccc...ddd...eee...fff...ggg...hhh...iii...jjj...kkk...yyy...zzz...
..aaa...bbb...ccc...ddd...eee...fff...ggg...hhh...iii...jjj...kkk...yyy...zzz...
................................................................................
................................................................................